Kreyella-like	Colpodida
Bryophrya_gemmea	Colpodida
Bryophryoides_ocellatus	Colpodida
Jaroschia_sumptuosa	Colpodida
Notoxoma_parabryophryides	Colpodida
Bryometopus_atypicus	Bursariomorphida
Bryometopus_pseudochilodon	Bursariomorphida
Bryometopus_sphagni	Bursariomorphida
Bryometopus_triquetrus	Bursariomorphida
Bursaria_ovata	Bursariomorphida
Bursaria_sp._213	Bursariomorphida
Bursaria_sp._891	Bursariomorphida
Bursaria_sp._212	Bursariomorphida
Bursaria_sp._890	Bursariomorphida
Bursaria_truncatella	Bursariomorphida
Bardeliella_pulchra	Colpodida
Bresslaua_vorax	Colpodida
Bresslauides_discoideus	Colpodida
Bromeliothrix_metopoides	Colpodida
Colpoda_cucullus	Colpodida
Colpoda_ecaudata	Colpodida
Colpoda_elliotti	Colpodida
Colpoda_henneguyi	Colpodida
Colpoda_inflata	Colpodida
Colpoda_lucida	Colpodida
Colpoda_maupasi	Colpodida
Emarginatophrya_aspera	Colpodida
Exocolpoda_augustini	Colpodida
Hausmanniella_discoidea	Colpodida
Ilsiella_palustris	Colpodida
Kalometopia_duplicata	Colpodida
Maryna_meridiana	Colpodida
Maryna_ovata	Colpodida
Maryna_umbrellata	Colpodida
Paracolpoda_steinii	Colpodida
Pseudomaryna_sp.	Colpodida
Repoma_cavicola	Colpodida
Sandmanniella_terricola	Colpodida
Tillina_magna	Colpodida
Tillina_minima	Colpodida
Tillina_sp.	Colpodida
Apocyrtolophosis_minor	Cyrtolophosidida
Aristerostoma_marinum	Cyrtolophosidida
Aristerostoma_sp.	Cyrtolophosidida
Cyrtolophosis_mucicola	Cyrtolophosidida
Microdiaphanosoma_arcuatum	Cyrtolophosidida
Pseudocyrtolophosis_alpestris	Cyrtolophosidida
Mykophagophrys_terricola	Colpodida
Pseudoplatyophrya_nana	Colpodida
Metopus_setosus	outgroup
Blepharisma_americanum	outgroup
Loxodes_magnus	outgroup
Spathidium_muscicola	outgroup
Furgasonia_blochmanni	outgroup
Nassula_labiata	outgroup
Obertrumia_georgiana	outgroup
Tetrahymena_thermophila	outgroup
Trithigmostoma_steini	outgroup
Plagiopylea_frontata	outgroup
Coleps_hirtus	outgroup
Halteria_grandinella	outgroup
Apowoodruffia_salinaria	Platyophryida
Etoschophrya_inornata	Platyophryida
Kuklikophrya_ougandae	Platyophryida
Ottowphrya_dragescoi	Platyophryida
Platyophrya_bromelicola	Platyophryida
Platyophrya_spumacola	Platyophryida
Platyophrya_vorax	Platyophryida
Platyophryides_macrostoma	Platyophryida
Platyophryides_magnus	Platyophryida
Sagittaria_venezuelensis	Platyophryida
Sagittariides_oblongistoma	Platyophryida
Sorogena_stoianovitchae	Platyophryida
Woodruffides_metabolicus	Platyophryida